wwwwwwwwwwwwwwwwwwwwwwwwwwwwwwwwwwwwwwwwwwwwwwwwwwwwwwwwwww
w                                                         w
w                                                         w
w                                                         w
w                                                         w
w                                                         w
w                                                         w
w                                                         w
w                                                         w
w                                                        ow
w                                swwwwwwwwwwwwwwwswwwwwwwww
w                                s               s        w
w         wwwwwwwwswwwwwwwwswwwwww               s        w
w                 s        s                     s        w
w                 s        s                     s        w
w  wwwwswwwww     s        s                     s   o    w
w      s          s                      wwwwwwwwwwwwwwswww
w      s          s                                    s  w
w      s          s                                    s  w
w      wwwwswwwwwwwwswww                               s  w
w          s                                           s  w
w          s                                           s  w
w          s                           k               s  w
wwswwswwwwwwww                      wwswwwwwwwwsww     s  w
w s                                            s       s  w
w s                                            s       s  w
w s                                            s  m    s  w
w s                                          wwwwwswwwwwwww
w s                                                       w
w s                                                       w
wwwwwwwwwsw                                               w
w        s            wwwsww   wswwswww                   w
w        s               s         s                      w
w        wswwwww     ww  s         s               m      w
w         s              s         swwwwww    wwwwwwwwswwww
w         s         w    s                            s   w
w        wwwwwwswwwwww   s                            s   w
w                        s                            s   w
w                        s                            s   w
w                        s   m                m       s   w
w                        wwwwwwwswwwwwwwwswwwwwwswwwwwwwwww
w                                               s         w
w                                               s         w
w                                               s         w
w                                               s         w
w                                               s         w
w                                               s         w
w                                              wwwwswww   w
w                                                  s      w
w                                                  s      w
w                                                  s      w
wi                                                 s      w
wwwwwwwwwwwwwwwwwwwwwwwwwwwwwwwwwwwwwwwwwwwwwwwwwwwwwwwwwww
