wwwwwwwwwwwwwwwwwwwwwwwwwwwwwwwwwwwwwwwwwwwwwwwwwwwwwwwwwww
w                                                         w
w                                     o          m        w
w                                  swwwwswwwwwwwwwwwwwwwwww
w                               swwww   s                 w
w                          swwwwww      s                 w
w               m   swwwwwwwww          s                 w
w      wwwwwwswwwwwwwwww                s                 w
w            s                      m   s         m       w
w            s                    wwwwwwwwwwwwwwswwwww    w
w            s                                  s         w
w            s                                  s         w
w            s             m                    s         w
w          wwwwwswwwwwwwwwwwwwwwwwwwwwwwwwwwwwwwwwwwwwwwwww
w               s                                         w
w               s                                         w
w               s           m                             w
w   wwswwwwwwwwwwwwwwwwwwwwwwwwwwwwwwwwwwwww              w
w     s                                                   w
w     s                                                   w
w     s                                                   w
w     wwwwwwwws                                           w
w             wwwswwwwwww                                 w
w                s                                        w
w                s           wwwwwwwwwwwwwwwwswwwww       w
w                s                           s            w
w                s       m                   s            w
w              wwwwwwwwwwwwwwww              s            w
w                                            s            w
w                                            s            w
w                                            wwsww        w
w                                              s          w
w                                              s          w
w                                              s          w
w                                              s          w
w                                              s          w
w                                       m      s          w
w  wwwwwwwswwwwwwwwwwwwwwwwwwwwwwwwwwwwwwwwwwwwwwwww      w
w         s                                               w
w         s                                               w
w         s                                               w
w     wwwwwwwwwwwws                  m                    w
w            wwwwwwwwwwwwwwwwwwwwwwwwwwwwwwwwwwwwswwwwwwwww
w                                                s        w
w                                                s        w
wi                                               s        w
wwwwwwwwwwwwwwwwwwwwwwwwwwwwwwwwwwwwwwwwwwwwwwwwwwwwwwwwwww
