wwwwwwwwwwwwwwwwwwwwwwwwwwwwwwwwwwwwwwwwwwwwwwwwwwwwwwwwwww
w                                                         w
w                                  o                      w
w                           wwwwwwwwwwwwws                w
w                                        s   m            w
w                                      wwwwswwww          w
w                                          s              w
w                                          s              w
w                                          s              w
w                               wwwwwwswwwwwww            w
w                                     s                   w
w                                     s                   w
w                                     s   m               w
w                                 wwwwswwwww              w
w                                     s                   w
w                                     s                   w
w                                     s     m             w
w                                    wwwwwswwwwwww        w
w                                         s               w
w                                         s               w
w                                         s               w
w                                         s               w
w                                        wwwwswww         w
w                                            s            w
w                                            s            w
w                                            s            w
w                                            s            w
w                                            s   m        w
w                                      wwwwwwswwwwww      w
w                                            s            w
w                                            s            w
w                                         m  s            w
w                              wwwwwwwwwswwwwwwwww        w
w                                       s                 w
w                                       s                 w
w                                       s   m             w
w                                      wwwwwwwwswwwwwwww  w
w                                              s          w
w                                              s          w
w                                              s     m    w
w                                          wwwwwwwswwwww  w
w                                                 s       w
w                                                 s       w
w                                                 s       w
wi                                                s       w
wwwwwwwwwwwwwwwwwwwwwwwwwwwwwwwwwwwwwwwwwwwwwwwwwwwwwwwwwww
