wwwwwwwwwwwwwwwwwwwwwwwwwwwwwwwwwwwwwwwwwwwwwwwwwwwwwwwwwww
w                                                         w
w                                                         w
w                                                         w
w                                                         w
www            m                                          w
w       wswwwwwwwwwwwwwwwww                               w
w        s               wwwwwwwwww                       w
w        s                    wwwwww                      w
w        s                ww    wwwwww                    w
w       wwwwsww           ww      wwwwwww   m             w
w           s             ww          wwwwwwwwwws         w
w           s             ww                    s         w
w           s             ww                    wwwwwwwww w
w           s             ww             wwwwwwwww        w
w          wwwwsww        ww      wwwwwwwwwww             w
w              s          ww                              w
w              s          wwwwwwwwswww                    w
w              s          ww      swww                    w
w              s          ww      s   m                   w
w             wwwwsww     ww      wwwwwwwwwswww           w
w                 s       ww               s              w
w                 s       ww               s              w
w                 s       ww               s              w
w                 s       ww               s              w
w            wwswwww      ww          m    s m            w
w              s          wwwwwwwwwwwwwwwwswwwwwwwwwwwwwwww
w              s          ww              s               w
w              s          ww              s               w
w              s          ww              s               w
w         wwswwww         ww              s m             w
w           s             ww          wwwwswwwwww         w
w           s             ww                              w
w           s             ww                              w
w           s             ww            m                 w
w      wwswwww            ww      wwwwwwswwwwwww          w
w        s                ww            s                 w
w        s                ww            s                 w
w        s                ww            sm                w
w        s                ww         wwwwwwwwwwwswwww     w
w   wwswwww               ww                    s         w
w     s                   ww                    s         w
w     s                   ww                    s         w
w     s                   ww                    s         w
w     s               i   ww           m        s        ow
wwwwwwwwwwwwwwwwwwwwwwwwwwwwwwwwwwwwwwwwwwwwwwwwwwwwwwwwwww
